1     
11    
1P1   
1C01  
1E001 
111111