1111111
11C1001
1001001
1N01NE1
1PN00C1
1111111