1111111111111111111111111
10000000000000000000P0001
1000000000000000000000001
1000000000000000000000001
100000000000000000000C001
100000E000000000000000001
1111111111111111111111111