111111111111111111111111111111111111111111111111111
1E00001000000000000000000000000000000000000000000C1
111110100000000000000000000000000000000000001111111
100010100000000000000000000000000000000000000111111
100010100000000000000000000000000000000000000011111
100000000000000000000000000000000000000000000000001
100000000000000000000000000000000000000000000000001
100000000000000000000000000000000000000000000000001
100000000000000000000000000000000000000000000000001
100000000000000000000000000000000000000000000000001
100000000000000000000000000000000000000000000000001
10000000P000000000000000000000000000000000000000001
111111111111111111111111111111111111111111111111111