1111111111111
1P000001C00C1
1110111C11101
1000100010001
1011101110111
100000C0000C1
1011101111101
1C000000000E1
1111111111111