1111111111111111111111111111111111111
10P00000000000CCCCCCCCCC000000000E001
1111111111111111111111111111111111111