11111111111
10P00000001
1000000CC01
100C00E0001
1000000C001
11111111111