11111111111
10PN0000001
1000000CC01
100C0NEN001
10N000NC0N1
11111111111