111111
110N01
1P1001
1C0101
1E0011
111111