1111111111
100000E001
1000000001
110000C001
1P10000001
1111111111